"","SNPs","genotype","CEDARO_PVL_no","CEDARO_PVL_yes","CEDARO_Colonization_no","CEDARO_Colonization_yes"
"1","SNP_rs369189796_ref_C","C",73,64,65,137
"2","SNP_rs369189796_ref_C","CC",35,32,32,67
"3","SNP_rs369189796_ref_C","CG",3,0,1,3
"4","SNP_rs369189796_ref_C","G",3,0,1,3
"5","SNP_rs11670330_ref_G","A",26,22,24,48
"6","SNP_rs11670330_ref_G","AA",4,3,6,7
"7","SNP_rs11670330_ref_G","G",50,42,42,92
"8","SNP_rs11670330_ref_G","GA",18,16,12,34
"9","SNP_rs11670330_ref_G","GG",16,13,15,29
"10","SNP_rs112996569_ref_C","C",68,64,61,132
"11","SNP_rs112996569_ref_C","CC",32,32,30,64
"12","SNP_rs112996569_ref_C","CT",4,0,1,4
"13","SNP_rs112996569_ref_C","T",8,0,5,8
"14","SNP_rs112996569_ref_C","TT",2,0,2,2
"15","SNP_rs113016810_ref_G","A",12,3,9,15
"16","SNP_rs113016810_ref_G","AA",3,1,1,4
"17","SNP_rs113016810_ref_G","G",46,35,43,81
"18","SNP_rs113016810_ref_G","GA",6,1,7,7
"19","SNP_rs113016810_ref_G","GG",20,17,18,37
"20","pos47269546_ref_A","A",1,0,0,1
"21","pos47269546_ref_A","AG",1,0,0,1
"22","pos47269546_ref_A","G",57,38,52,95
"23","pos47269546_ref_A","GG",28,19,26,47
"24","DEL_rs397897664","del(A)",33,26,31,59
"25","SNP_rs201148720_ref_C","A",18,10,10,28
"26","SNP_rs201148720_ref_C","AA",9,5,5,14
"27","SNP_rs201148720_ref_C","C",48,42,52,90
"28","SNP_rs201148720_ref_C","CC",24,21,26,45
"29","SNP_rs4467185_ref_G","A",49,56,59,105
"30","SNP_rs4467185_ref_G","AA",21,26,26,47
"31","SNP_rs4467185_ref_G","G",13,4,9,17
"32","SNP_rs4467185_ref_G","GA",7,4,7,11
"33","SNP_rs4467185_ref_G","GG",3,0,1,3
"34","pos47320035_ref_C","A",1,0,1,1
"35","pos47320035_ref_C","C",69,62,67,131
"36","pos47320035_ref_C","CA",1,0,1,1
"37","pos47320035_ref_C","CC",34,31,33,65
"38","SNP_rs61733735_ref_C","C",56,55,55,111
"39","SNP_rs61733735_ref_C","CC",24,26,24,50
"40","SNP_rs61733735_ref_C","CG",8,3,7,11
"41","SNP_rs61733735_ref_C","G",16,3,9,19
"42","SNP_rs61733735_ref_C","GG",4,0,1,4
"43","SNP_rs36028765_ref_G","A",1,1,0,2
"44","SNP_rs36028765_ref_G","G",71,57,66,128
"45","SNP_rs36028765_ref_G","GA",1,1,0,2
"46","SNP_rs36028765_ref_G","GG",35,28,33,63
"47","SNP_rs11880097_ref_G","G",16,2,9,18
"48","SNP_rs11880097_ref_G","GG",3,0,1,3
"49","SNP_rs11880097_ref_G","GT",10,2,7,12
"50","SNP_rs11880097_ref_G","T",52,58,55,110
"51","SNP_rs11880097_ref_G","TT",21,28,24,49
"52","SNP_rs36046934_ref_G","A",1,1,0,2
"53","SNP_rs36046934_ref_G","G",73,59,66,132
"54","SNP_rs36046934_ref_G","GA",1,1,0,2
"55","SNP_rs36046934_ref_G","GG",36,29,33,65
"56","SNP_rs150649665_ref_C","A",8,1,4,9
"57","SNP_rs150649665_ref_C","AA",1,0,0,1
"58","SNP_rs150649665_ref_C","C",66,63,62,129
"59","SNP_rs150649665_ref_C","CA",6,1,4,7
"60","SNP_rs150649665_ref_C","CC",30,31,29,61
"61","SNP_rs115216760_ref_G","A",3,2,3,5
"62","SNP_rs115216760_ref_G","G",71,62,63,133
"63","SNP_rs115216760_ref_G","GA",3,2,3,5
"64","SNP_rs115216760_ref_G","GG",34,30,30,64
"65","SNP_rs4482395_ref_A","G",64,60,64,124
"66","SNP_rs4482395_ref_A","GG",32,30,32,62
"67","SNP_rs115584235_ref_C","C",62,55,61,117
"68","SNP_rs115584235_ref_C","CC",30,25,29,55
"69","SNP_rs115584235_ref_C","CT",2,5,3,7
"70","SNP_rs115584235_ref_C","T",2,5,3,7
"71","SNP_rs187635721_ref_G","G",51,56,53,107
"72","SNP_rs187635721_ref_G","GG",23,27,23,50
"73","SNP_rs187635721_ref_G","GT",5,2,7,7
"74","SNP_rs187635721_ref_G","T",11,2,9,13
"75","SNP_rs187635721_ref_G","TT",3,0,1,3
"76","SNP_rs112290646_ref_A","A",60,59,57,119
"77","SNP_rs112290646_ref_A","AA",28,28,26,56
"78","SNP_rs112290646_ref_A","AG",4,3,5,7
"79","SNP_rs112290646_ref_A","G",10,3,7,13
"80","SNP_rs112290646_ref_A","GG",3,0,1,3
